SOS	
sos	
DECL	G
decl	G
QUEST	G
quest	G
PRESENT	G
present	G
PAST	G
past	G
the	D
some	D
my	D
your	D
our	D
her	D
newt	N
newts	N
orangutan	N
orangutans	N
peacock	N
peacocks	N
quail	N
quails	N
raven	N
ravens	N
salamander	N
salamanders	N
tyrannosaurus	N
tyrannosauruses	N
unicorn	N
unicorns	N
vulture	N
vultures	N
walrus	N
walruses	N
xylophone	N
xylophones	N
yak	N
yaks	N
zebra	N
zebras	N
giggle	V
smile	V
sleep	V
swim	V
wait	V
move	V
change	V
read	V
eat	V
entertain	V
amuse	V
high_five	V
applaud	V
confuse	V
admire	V
accept	V
remember	V
comfort	V
can	A
will	A
could	A
would	A
do	A
does	A
don't	A
doesn't	A
around	P
near	P
with	P
upon	P
by	P
behind	P
above	P
below	P
who	R
that	R
.	T
?	T
+Q	K
+q	K
-Q	K
-q	K
t	C
giggles	V
smiles	V
sleeps	V
swims	V
waits	V
moves	V
changes	V
reads	V
eats	V
entertains	V
amuses	V
high_fives	V
applauds	V
confuses	V
admires	V
accepts	V
remembers	V
comforts	V
giggled	V
smiled	V
slept	V
swam	V
waited	V
moved	V
changed	V
read	V
ate	V
entertained	V
amused	V
high_fived	V
applauded	V
confused	V
admired	V
accepted	V
remembered	V
comforted	V
did	A
didn't	A
